########
#   # .#
#   $$.#
####   #
   #@ ##
   ####