########
#   # .#
#    $*#
####   #
   #@ ##
   ####