########
#   # .#
#   $$+#
####   #
   #  ##
   ####